109 109 109 109 109 109 109 109 109 109 109 109 109 109 109 109 109 109 109 109 109 109 109 109 109 109 109 109 109 109 
109 109 109 109 109 109 109 109 109 109 109 109 109 109 109 109 109 109 109 109 109 109 109 109 109 109 109 109 109 109 
109 109 109 109 109 109 109 109 109 109 109 109 109 109 109 109 109 109 109 109 109 109 109 109 109 109 109 109 109 109 
109 109 109 109 109 109 109 109 109 109 60 60 60 60 60 60 60 60 60 60 60 60 60 60 60 60 60 60 60 109 
109 109 109 109 109 109 109 109 109 109 60 60 60 60 60 60 60 60 60 60 60 60 60 60 60 60 60 60 60 109 
109 109 109 109 109 109 109 109 109 109 60 60 60 60 60 60 60 60 60 60 60 60 60 60 60 60 60 60 60 109 
109 109 109 109 109 109 109 109 109 109 60 60 60 60 60 60 60 60 60 60 60 60 60 60 60 60 60 60 60 109 
109 109 109 109 109 109 109 109 109 109 60 60 60 60 60 60 60 60 60 60 60 60 60 60 60 60 60 60 60 109 
109 109 109 109 109 109 109 109 109 109 60 60 60 60 60 60 60 60 60 60 60 60 60 60 60 60 60 60 60 109 
109 109 109 109 109 109 109 109 109 109 60 60 60 60 60 60 60 60 60 60 109 109 109 109 109 109 109 109 109 109 
109 109 109 109 109 109 109 109 109 109 60 60 60 60 60 60 60 60 60 60 109 109 109 109 109 109 109 109 109 109 
109 109 109 109 109 109 109 109 109 109 60 60 60 60 60 60 60 60 60 60 109 109 109 109 109 109 109 109 109 109 
109 109 109 109 109 109 109 109 109 109 60 60 60 60 60 60 60 60 60 60 109 109 109 109 109 109 109 109 109 109 
108 108 109 109 109 109 109 109 109 109 60 60 60 60 60 60 60 60 60 60 109 109 109 109 109 109 109 109 109 109 
108 108 108 108 108 108 108 109 109 109 109 109 109 109 170 170 109 109 109 109 109 109 109 109 109 109 109 109 109 109 
108 108 108 108 108 108 108 108 108 108 109 109 109 109 170 170 109 109 109 109 109 109 109 109 109 109 109 109 109 109 
108 108 108 108 108 108 108 108 108 108 108 108 108 108 108 108 108 108 108 108 108 108 108 108 108 108 109 109 109 109 
