200 175 173 172 176 176 176 175 175 175 175 172 198 96 96 96 96 196 176 176 176 172 175 175 174 174 176 174 172 196 
191 225 229 229 226 96 96 96 96 96 96 96 96 96 96 96 96 96 96 96 96 96 96 96 96 225 229 229 226 182 
189 227 221 221 228 96 96 96 96 96 96 96 96 96 96 96 96 96 96 96 96 96 96 96 96 227 221 221 228 184 
190 227 221 221 228 96 96 96 96 96 96 96 96 96 96 96 96 96 96 96 96 96 96 96 96 227 221 221 228 185 
188 227 221 221 228 96 96 96 96 96 96 96 96 96 96 96 96 96 96 96 96 96 96 96 96 227 221 221 228 185 
191 227 221 221 228 96 96 96 96 96 96 96 96 96 96 96 96 96 96 96 96 96 96 96 96 227 221 221 228 183 
189 227 221 221 228 96 96 96 96 96 96 96 96 96 96 96 96 96 96 96 96 96 96 96 96 227 221 221 228 182 
189 227 221 221 228 96 96 96 96 96 96 96 96 96 96 96 96 96 96 96 96 96 96 96 96 227 221 221 228 182 
188 227 221 221 228 96 96 96 96 96 96 96 96 96 96 96 96 96 96 96 96 96 96 96 96 227 221 221 228 182 
189 227 221 221 228 96 96 96 96 96 96 96 96 96 96 96 96 96 96 96 96 96 96 96 96 227 221 221 228 182 
189 227 221 221 228 96 96 96 96 96 96 96 96 96 96 96 96 96 96 96 96 96 96 96 96 227 221 221 228 182 
191 227 221 221 228 96 96 96 96 96 96 96 96 96 96 96 96 96 96 96 96 96 96 96 96 227 221 221 228 210 
189 227 221 221 228 96 96 96 96 96 96 96 96 96 96 96 96 96 96 96 96 96 96 96 96 227 221 221 228 184 
189 227 221 221 228 96 96 96 96 96 96 96 96 96 96 96 96 96 96 96 96 96 96 96 96 227 221 221 228 183 
188 227 221 221 228 96 96 96 96 96 96 96 96 96 96 96 96 96 96 96 96 96 96 96 96 227 221 221 228 185 
190 223 222 222 224 96 96 96 96 96 96 96 96 96 96 96 96 96 96 96 96 96 96 96 96 223 222 222 224 183 
204 181 181 181 181 181 181 181 181 181 181 181 177 181 181 180 177 179 180 178 181 178 181 181 181 181 177 181 179 206 
