0 0 0 0 0 0 0 0 0 0 47 161 169 169 162 47 0 0 0 0 0 0 0 0 0 0 0 0 0 0 
0 0 0 0 0 0 0 0 0 0 0 165 169 169 169 166 0 0 0 0 0 0 0 0 0 0 0 0 0 0 
0 0 0 0 54 55 0 0 0 0 0 0 164 169 169 166 0 0 0 54 55 0 0 0 0 0 0 0 0 0 
0 0 0 0 0 0 0 0 0 0 0 0 0 160 164 0 0 0 0 0 0 0 0 0 0 0 0 0 0 0 
0 0 0 0 0 0 0 0 0 0 0 0 0 0 0 0 0 0 0 0 0 52 53 0 0 0 0 0 0 0 
0 0 0 0 0 0 0 0 0 0 0 0 0 0 52 53 0 0 0 0 0 0 0 0 52 53 0 0 0 0 
0 0 52 53 0 0 0 0 0 0 0 0 0 0 0 0 0 0 0 0 0 0 0 0 0 0 0 0 0 0 
0 0 144 153 152 145 0 0 0 0 0 0 0 0 0 0 0 0 0 0 0 0 0 0 146 153 145 0 0 0 
0 144 326 0 0 327 153 153 152 152 153 152 145 0 0 0 0 0 0 0 0 0 144 153 326 0 327 153 152 153 
153 326 0 0 0 0 0 0 0 0 0 0 327 152 145 0 0 0 146 152 153 152 326 0 0 0 0 0 0 0 
0 0 0 0 0 0 0 0 0 0 0 0 0 0 327 153 152 152 326 0 0 0 0 0 0 0 0 0 0 0 
0 0 0 0 0 0 0 0 0 54 55 0 0 0 0 0 0 0 0 0 0 0 0 0 0 0 0 0 0 0 
0 0 0 0 0 0 0 0 0 0 0 0 0 0 0 0 0 0 0 0 0 0 0 0 0 0 0 0 0 0 
0 0 0 0 0 0 0 0 0 0 0 0 0 163 167 163 167 0 0 0 0 0 0 0 0 0 0 0 0 0 
0 0 0 0 0 0 0 0 0 0 0 0 161 169 168 169 169 162 0 0 0 0 0 0 0 0 0 0 0 0 
0 0 0 0 0 0 0 0 0 0 0 0 165 168 169 169 168 166 0 0 0 0 0 0 0 0 0 0 0 0 
0 0 0 0 0 0 0 0 0 0 0 47 165 169 168 168 169 162 47 0 0 0 0 0 0 0 0 0 0 0 
