0 0 0 0 0 0 0 0 0 0 0 0 0 0 0 0 0 0 0 0 0 0 0 0 0 0 0 0 0 0 
0 0 0 0 0 0 0 0 0 0 0 0 0 0 0 0 0 0 0 0 0 0 0 0 0 0 0 0 0 0 
0 0 0 0 0 0 0 0 0 0 0 0 0 0 0 0 0 0 0 0 0 0 0 0 0 0 0 0 0 0 
0 0 0 0 0 0 0 0 0 0 0 0 0 0 0 144 152 145 0 0 0 0 0 0 0 0 0 0 0 0 
0 0 0 0 0 0 0 0 0 0 0 0 0 144 153 326 0 327 152 147 0 0 0 0 0 0 0 0 0 0 
0 0 0 0 0 0 0 0 0 0 0 0 146 326 0 167 163 167 0 327 147 0 0 0 0 0 0 0 0 0 
125 0 0 0 0 0 0 0 0 0 0 0 157 0 0 0 0 0 0 0 158 0 0 0 0 0 0 0 0 144 
124 0 0 0 0 0 0 0 0 0 0 144 326 161 0 0 0 0 0 166 327 145 0 0 0 0 0 0 146 326 
125 0 0 0 0 0 0 0 0 0 0 156 0 165 0 0 0 0 0 162 0 159 0 0 0 0 0 0 156 0 
124 0 0 0 0 0 0 0 0 0 0 150 324 165 0 0 0 0 0 166 325 149 0 0 0 0 0 0 150 324 
125 0 0 0 0 0 0 0 0 0 0 0 157 0 0 0 0 0 0 0 158 0 0 0 0 0 0 0 0 148 
0 0 0 0 0 0 0 0 0 0 0 0 148 324 0 164 160 164 0 325 149 0 0 0 0 0 0 0 0 0 
0 0 0 0 0 0 0 0 0 0 0 0 0 150 154 324 0 325 154 151 0 0 0 0 0 0 0 0 0 0 
0 0 0 0 0 0 0 0 0 0 0 0 0 0 0 148 155 149 0 0 0 0 0 0 0 0 0 0 0 0 
0 0 0 0 0 0 0 0 0 0 0 0 0 0 0 0 0 0 0 0 0 0 0 0 0 0 0 0 0 0 
0 0 0 0 0 0 0 0 0 0 0 0 0 0 0 0 0 0 0 0 0 0 0 0 0 0 0 0 0 0 
0 0 0 0 0 0 0 0 0 0 0 0 0 0 0 0 0 0 0 0 0 0 0 0 0 0 0 0 0 0 
