191 110 110 110 110 110 110 110 110 110 110 110 110 110 110 110 110 110 110 110 110 110 110 110 110 110 110 110 110 110 
187 110 110 110 110 110 110 110 110 110 110 110 110 110 110 110 110 110 110 110 110 110 110 110 110 110 110 110 110 110 
191 110 110 110 110 110 110 110 110 110 110 110 110 110 110 110 110 110 110 110 110 110 110 110 110 110 110 110 110 110 
191 110 110 110 110 110 110 110 110 110 110 110 110 110 110 109 109 109 110 110 110 110 110 110 110 110 110 110 110 110 
187 110 110 110 110 110 110 110 110 110 110 110 110 109 109 109 109 109 109 109 110 110 110 110 110 110 110 110 110 110 
200 110 110 110 110 110 110 110 110 110 110 110 109 109 109 109 109 109 109 109 109 110 110 110 110 110 110 110 110 110 
110 110 110 110 110 110 110 110 110 110 110 110 109 109 168 168 169 168 168 109 109 110 110 110 110 110 110 110 110 170 
110 110 110 110 110 110 110 110 110 110 110 109 109 109 168 169 168 169 169 109 109 109 110 110 110 110 110 110 170 170 
110 110 110 110 110 110 110 110 110 110 110 109 109 109 169 168 169 168 168 109 109 109 110 110 110 110 110 110 170 170 
110 110 110 110 110 110 110 110 110 110 110 109 109 109 168 169 168 169 168 109 109 109 110 110 110 110 110 110 170 170 
110 110 110 110 110 110 110 110 110 110 110 110 109 109 169 169 168 169 168 109 109 110 110 110 110 110 110 110 110 170 
202 110 110 110 110 110 110 110 110 110 110 110 109 109 109 109 109 109 109 109 109 110 110 110 110 110 110 110 110 110 
191 110 110 110 110 110 110 110 110 110 110 110 110 109 109 109 109 109 109 109 110 110 110 110 110 110 110 110 110 110 
191 110 110 110 110 110 110 110 110 110 110 110 110 110 110 109 109 109 110 110 110 110 110 110 110 110 110 110 110 110 
187 110 110 110 110 110 110 110 110 110 110 110 110 110 110 110 110 110 110 110 110 110 110 110 110 110 110 110 110 110 
187 110 110 110 110 110 110 110 110 110 110 110 110 110 110 110 110 110 110 110 110 110 110 110 110 110 110 110 110 110 
190 110 110 110 110 110 110 110 110 110 110 110 110 110 110 110 110 110 110 110 110 110 110 110 110 110 110 110 110 110 
