0 0 0 0 0 0 0 0 0 0 0 0 0 0 0 0 0 0 0 0 0 0 0 0 0 0 0 0 0 0 
0 0 0 0 0 0 0 0 0 0 0 0 0 0 0 0 0 0 0 0 0 0 0 0 0 305 0 0 309 0 
0 0 0 0 0 0 0 0 0 0 0 0 0 0 0 0 0 0 0 0 0 0 0 289 287 287 287 287 287 287 
0 0 0 0 0 0 0 0 0 0 0 0 0 0 0 0 0 0 0 0 289 287 287 285 0 0 0 0 0 0 
0 0 0 0 0 0 0 0 0 0 0 0 0 0 0 0 289 287 287 287 285 0 0 0 0 0 0 0 0 0 
0 0 0 0 0 0 0 0 0 289 287 287 287 287 287 287 285 0 307 0 0 0 0 0 0 0 0 0 0 0 
0 0 0 0 0 0 0 289 287 285 0 0 0 0 0 0 0 0 0 0 0 0 0 0 0 0 0 0 0 0 
0 0 0 0 0 0 289 285 0 0 0 0 0 0 0 0 0 0 0 0 0 0 0 0 0 0 0 0 0 0 
0 0 0 0 0 289 285 0 0 0 0 0 0 0 0 0 0 0 0 0 0 0 0 0 0 0 0 0 0 0 
0 0 0 0 289 285 0 0 0 0 0 0 0 0 0 0 0 0 0 0 0 0 0 0 0 0 0 0 0 0 
0 0 308 289 285 0 0 0 0 0 0 0 0 0 0 0 0 0 0 0 0 0 0 0 0 280 286 286 286 286 
289 287 287 285 0 0 0 0 0 0 0 0 0 0 0 0 0 0 0 0 0 0 0 280 286 290 0 0 311 0 
285 0 0 0 0 0 0 0 0 0 0 0 0 0 0 0 0 0 0 280 286 286 286 290 0 0 0 0 0 0 
0 0 0 0 0 0 0 0 0 0 0 0 0 0 0 0 0 280 286 290 0 311 0 0 0 0 0 0 0 0 
0 0 0 0 0 0 0 0 0 0 0 0 0 0 0 0 0 282 0 0 0 0 0 0 0 0 0 0 0 0 
0 0 0 0 0 0 0 0 0 0 0 0 0 0 0 280 286 290 0 0 310 0 0 0 0 0 0 0 0 309 
0 0 0 0 0 0 0 0 0 0 0 0 0 280 286 290 309 0 0 0 0 0 0 308 0 0 0 0 311 0 
