200 175 173 172 176 176 176 175 175 175 176 176 176 176 176 176 176 176 176 176 176 172 175 175 174 174 176 174 172 196 
191 96 96 96 96 96 96 96 96 96 96 96 96 96 96 96 96 96 96 96 96 96 96 96 96 96 96 96 96 182 
189 96 96 96 96 96 96 96 96 96 96 96 96 96 96 96 96 96 96 96 96 96 96 96 96 96 96 96 96 184 
190 96 96 96 96 96 96 96 96 96 96 96 96 96 96 96 96 96 96 96 96 96 96 96 96 96 96 96 96 185 
188 96 96 96 96 96 96 96 96 96 96 96 96 96 96 96 96 96 96 96 96 96 96 96 96 96 96 96 96 185 
191 96 96 96 96 96 96 96 96 96 96 96 96 96 96 96 225 229 229 229 226 96 96 96 96 96 96 96 96 183 
197 96 96 96 96 96 96 96 96 96 96 225 229 229 229 229 221 221 221 221 221 226 96 96 96 96 96 96 96 185 
96 96 96 96 96 96 96 96 225 229 229 221 221 221 221 221 221 221 221 221 221 221 226 60 60 96 96 96 96 185 
96 96 96 96 96 96 225 229 221 221 221 221 221 221 221 221 221 221 221 221 221 221 221 60 60 60 60 96 96 185 
96 96 96 96 96 225 221 221 221 221 221 222 222 222 222 222 222 222 222 222 221 221 221 60 60 60 60 96 96 185 
96 96 96 96 96 227 221 221 221 221 224 96 96 96 96 96 96 96 96 96 223 222 222 60 60 60 60 229 226 185 
205 96 96 225 229 221 221 221 221 224 96 96 96 96 96 96 96 96 96 96 96 96 96 60 60 60 60 227 228 185 
189 225 229 221 221 221 221 221 228 96 96 96 96 96 96 96 96 96 96 96 96 96 96 60 60 60 60 227 228 184 
189 227 221 221 221 221 221 221 228 96 96 96 96 96 96 96 96 96 96 96 96 96 96 96 96 60 60 227 228 183 
188 227 221 221 221 221 221 221 221 226 96 96 96 96 96 96 96 96 96 96 96 96 96 96 96 96 96 227 228 185 
190 223 222 222 222 222 222 222 222 222 222 96 96 96 96 96 96 96 96 96 96 96 96 96 96 96 96 223 224 183 
204 181 181 181 181 181 181 181 181 181 181 178 205 96 96 96 96 96 210 178 181 178 181 181 181 181 177 181 179 206 
