0 0 0 0 0 0 0 0 0 0 0 0 0 0 0 0 0 0 0 0 0 0 0 0 0 0 0 0 0 0 
0 0 0 95 95 95 0 0 0 0 95 95 95 0 0 0 0 0 0 0 0 0 0 231 0 95 95 95 95 0 
0 0 0 95 95 95 0 0 0 0 95 95 0 0 0 0 0 0 0 0 0 0 0 0 0 95 95 95 95 0 
0 0 0 0 0 0 0 0 0 0 0 0 0 0 0 0 0 0 0 0 0 0 0 0 0 0 0 0 0 0 
0 0 0 0 230 0 0 0 0 0 0 232 0 0 0 0 0 0 0 0 0 0 0 0 0 0 0 0 0 0 
0 0 0 0 0 0 0 0 0 95 95 0 0 0 0 0 0 0 0 0 0 0 0 0 0 0 0 0 276 0 
0 0 0 0 0 0 0 0 0 95 0 0 0 0 0 0 0 0 0 0 0 0 0 0 0 0 0 0 0 0 
0 0 0 0 0 0 0 0 95 95 0 0 0 0 0 0 0 0 0 0 0 0 0 0 0 0 0 0 0 0 
0 0 0 0 0 0 0 0 95 95 0 0 0 0 0 0 0 0 0 0 0 0 0 0 0 0 0 0 0 0 
0 0 0 0 0 0 0 0 0 0 0 0 0 0 0 0 0 0 0 0 95 95 0 230 0 0 0 0 0 0 
0 0 0 0 0 0 0 0 0 0 0 0 0 0 0 0 0 0 0 0 95 0 0 0 0 0 0 0 0 0 
0 0 0 0 0 0 0 0 0 0 0 0 0 0 0 0 277 0 0 95 95 0 0 0 0 0 0 0 0 0 
0 66 66 75 0 0 0 0 0 0 0 0 0 0 0 0 0 0 0 95 95 0 0 0 0 0 0 0 0 0 
0 95 0 68 0 0 0 0 0 0 0 0 0 0 0 0 0 0 0 0 0 0 0 0 66 66 66 66 66 0 
0 95 95 68 0 0 0 0 0 0 0 0 0 0 95 95 0 0 0 0 0 0 0 0 95 95 95 95 95 0 
0 95 95 68 231 0 0 0 0 0 0 0 0 95 95 95 0 0 0 0 0 0 0 0 95 95 95 95 95 0 
0 0 0 0 0 0 0 0 0 0 0 0 0 0 0 0 0 0 0 0 0 0 0 0 0 0 0 0 0 0 
