200 175 173 172 176 176 176 176 176 176 176 172 176 172 174 175 174 176 176 176 176 172 175 175 174 174 176 174 172 196 
191 96 96 96 96 96 206 177 204 96 96 96 96 96 96 96 96 96 96 96 96 96 96 96 96 96 96 96 96 182 
189 96 96 96 96 96 185 216 187 96 96 96 96 96 96 96 96 96 96 96 96 96 96 96 96 96 96 96 96 184 
190 96 96 96 96 96 186 217 187 96 96 96 96 96 96 96 96 96 96 96 96 96 96 96 96 96 96 96 96 185 
188 96 96 96 96 96 185 216 187 96 96 96 96 96 96 96 96 96 96 96 96 96 96 96 96 96 96 96 96 185 
200 96 96 96 96 96 185 215 187 96 96 96 96 96 96 96 96 96 96 96 96 96 96 96 96 96 96 96 96 196 
96 96 96 96 96 96 193 174 197 96 170 170 170 170 170 170 170 170 170 170 96 96 96 96 96 96 96 96 96 96 
96 96 96 96 96 96 96 96 96 96 170 170 170 170 170 170 170 170 170 170 96 96 96 96 96 96 96 96 96 96 
96 96 96 96 96 96 96 96 96 96 170 170 170 170 170 170 170 170 170 170 96 96 96 96 96 96 96 96 96 96 
96 96 96 96 96 96 96 96 96 96 170 170 170 170 170 170 170 170 170 170 96 96 96 96 96 96 96 96 96 96 
96 96 96 96 96 96 96 96 96 96 170 170 170 170 170 170 170 170 170 170 96 208 181 203 96 96 96 96 96 96 
204 96 96 96 96 96 96 96 96 96 96 96 96 96 96 96 96 96 96 96 96 184 215 190 96 96 96 96 96 208 
189 96 96 96 96 96 96 96 96 96 96 96 96 96 96 96 96 96 96 96 96 186 215 188 96 96 96 96 96 184 
189 96 96 96 96 96 96 96 96 96 96 96 96 96 96 96 96 96 96 96 96 185 217 190 96 96 96 96 96 183 
188 96 96 96 96 96 96 96 96 96 96 96 96 96 96 96 96 96 96 96 96 185 216 191 96 96 96 96 96 185 
190 96 96 96 96 96 96 96 96 96 96 96 96 96 96 96 96 96 96 96 96 193 176 197 96 96 96 96 96 183 
204 181 181 181 181 181 181 181 181 181 181 181 178 178 178 180 180 177 181 178 181 177 180 180 181 181 177 181 179 206 
