200 175 173 172 176 176 176 175 175 175 175 172 189 96 96 96 96 196 176 176 176 172 175 175 174 174 176 174 172 196 
191 96 96 96 96 96 96 185 215 217 216 215 187 96 96 96 96 96 96 96 96 96 96 96 96 96 96 96 96 182 
189 96 96 96 96 96 96 184 215 216 216 217 190 96 96 96 96 96 96 96 96 96 96 96 96 96 96 96 96 184 
190 96 96 96 96 96 96 185 216 215 217 217 190 96 96 96 96 96 96 96 96 96 96 96 96 96 96 96 96 185 
188 96 96 96 96 96 96 183 217 217 215 217 190 96 96 96 96 96 96 96 96 96 96 96 96 96 96 96 96 185 
191 96 96 96 96 96 96 184 216 216 216 216 188 96 96 96 96 96 96 96 96 96 96 96 96 96 96 96 96 183 
200 96 96 96 96 96 96 184 216 216 216 216 205 181 178 179 181 181 181 179 178 181 203 96 96 96 96 96 96 186 
96 96 96 96 96 96 96 185 217 216 216 216 215 215 216 215 217 215 215 216 215 217 188 96 96 96 96 96 96 185 
96 96 96 96 96 96 96 185 215 216 216 216 217 215 215 217 215 215 215 216 217 216 189 96 96 96 96 96 96 186 
96 96 96 96 96 96 96 185 217 200 173 176 176 176 173 176 176 174 175 176 176 176 200 96 96 96 96 96 96 182 
96 96 96 96 96 96 96 184 216 191 96 96 96 96 96 96 96 96 96 96 96 96 96 96 96 96 96 96 96 186 
205 96 96 96 96 96 96 183 215 188 96 96 96 96 96 96 96 96 96 96 96 96 96 96 96 96 96 96 96 184 
189 96 96 96 96 96 96 196 174 200 96 96 96 96 96 96 96 96 96 96 96 96 96 96 96 96 96 96 96 184 
189 96 96 96 96 96 96 96 96 96 96 96 96 96 96 96 96 96 96 96 96 96 96 96 96 96 96 96 96 183 
188 96 96 96 96 96 96 96 96 96 96 96 96 96 96 96 96 96 96 96 96 96 96 96 96 96 96 96 96 185 
190 96 96 96 96 96 96 96 96 96 96 96 96 96 96 96 96 96 96 96 96 96 96 96 96 96 96 96 96 183 
204 181 181 181 181 181 181 181 181 181 181 181 177 181 181 180 177 179 180 178 181 178 181 181 181 181 177 181 179 206 
