0 0 0 0 0 0 0 309 0 0 0 0 0 0 0 0 0 0 0 0 0 0 0 0 0 0 0 0 0 0 
0 0 0 0 0 0 0 0 0 0 0 0 0 0 0 0 304 0 0 0 0 0 0 0 0 0 0 0 0 0 
0 0 0 0 0 0 0 0 0 0 0 0 0 0 0 308 0 305 0 0 0 0 0 0 0 0 0 0 0 0 
0 0 311 0 0 0 0 0 0 0 0 0 0 0 0 0 0 0 0 0 0 0 0 0 0 0 0 0 0 0 
0 0 0 0 0 0 0 0 0 310 0 0 0 0 0 0 0 0 0 0 0 0 0 0 0 0 0 0 0 0 
0 0 0 0 0 0 0 0 309 0 0 0 0 0 0 0 0 0 0 0 0 0 0 0 0 0 0 0 0 0 
0 0 0 0 0 0 0 0 0 0 0 0 0 0 0 0 0 0 0 0 0 0 0 0 0 0 0 0 0 0 
0 0 310 289 287 287 287 287 288 0 0 0 0 0 0 0 0 58 62 62 62 62 62 62 62 62 62 62 62 62 
0 0 289 285 0 0 0 0 284 288 0 0 0 0 0 0 0 63 0 0 0 0 0 0 0 0 0 0 0 0 
287 287 285 0 0 0 0 0 0 284 288 308 0 0 0 0 0 0 63 0 0 306 0 0 0 0 0 0 0 0 
0 0 0 0 0 0 0 0 0 0 284 287 288 0 0 0 311 0 63 0 0 0 0 0 0 0 0 0 0 0 
0 0 0 0 0 0 0 0 0 0 0 0 284 287 287 287 288 0 57 61 61 61 61 61 61 61 61 61 61 61 
0 0 0 0 0 0 0 0 0 0 0 0 0 0 0 0 284 288 0 0 0 0 0 0 0 0 0 0 0 0 
0 0 0 0 0 0 0 0 0 0 0 0 0 0 0 0 0 284 288 0 0 0 0 0 0 0 0 0 0 0 
0 0 0 0 0 0 0 0 0 0 310 0 0 0 0 0 0 0 284 287 288 0 0 0 0 0 0 0 0 0 
0 0 0 0 0 0 0 0 0 0 0 0 0 0 0 0 0 305 0 0 284 287 0 0 0 0 0 0 0 0 
0 0 0 0 0 0 0 0 0 0 0 0 0 0 0 0 0 0 309 0 0 0 0 0 0 0 0 0 0 0 
