221 221 221 221 221 221 221 221 228 278 278 278 217 215 218 218 218 218 218 218 279 279 279 279 279 279 279 279 279 279 
221 221 221 221 221 221 221 221 224 278 278 278 216 215 219 218 218 219 219 219 279 279 279 279 279 279 279 279 279 279 
221 221 221 221 221 221 221 228 278 278 278 215 216 220 218 220 219 218 219 218 219 279 279 279 279 279 279 279 279 279 
221 221 221 221 221 221 221 224 278 278 278 216 215 219 219 219 218 219 218 219 219 219 219 279 279 279 279 279 279 279 
221 221 221 221 221 221 228 278 278 278 278 216 216 219 219 219 219 219 219 218 219 219 219 279 279 279 279 279 279 279 
221 221 221 221 221 221 224 278 278 278 278 217 220 220 219 219 219 219 219 219 219 219 219 218 279 279 279 279 279 279 
221 221 221 221 221 228 278 278 278 278 216 217 218 220 219 219 219 219 219 219 219 219 218 218 279 279 279 279 279 279 
222 222 222 222 222 224 278 278 278 278 215 215 220 220 218 220 220 220 219 219 220 220 219 220 219 279 279 279 279 279 
60 60 60 60 60 60 278 278 278 278 215 216 220 220 220 220 219 219 219 219 219 219 218 219 219 279 279 279 279 279 
60 60 60 60 60 60 278 278 278 278 216 215 220 220 220 219 218 219 219 219 219 219 219 220 220 279 279 279 279 279 
60 60 60 60 60 60 278 278 278 278 216 220 220 220 220 219 219 219 220 218 219 219 218 218 279 279 279 279 279 279 
229 229 229 229 229 226 278 278 278 278 216 220 220 218 220 219 219 219 220 218 220 218 218 218 279 279 279 279 279 279 
221 221 221 221 221 228 278 278 278 278 216 220 220 220 219 219 219 220 219 218 218 220 218 279 279 279 279 279 279 279 
221 221 221 221 221 228 278 278 278 216 216 220 220 219 219 219 219 219 219 218 218 218 218 279 279 279 279 279 279 279 
221 221 221 221 221 228 278 278 278 215 215 219 220 218 218 219 219 219 218 218 218 218 279 279 279 279 279 279 279 279 
221 221 221 221 221 224 278 278 278 216 215 217 219 219 219 219 219 219 218 218 218 279 279 279 279 279 279 279 279 279 
221 221 221 221 228 278 278 278 278 278 216 216 220 220 218 218 220 218 218 220 279 279 279 279 279 279 279 279 279 279 
