110 110 110 110 110 110 110 110 110 110 110 110 110 110 110 110 110 110 110 110 110 110 110 110 110 110 110 110 110 110 
110 110 110 110 110 110 110 110 110 110 110 110 110 110 109 109 109 109 109 109 110 110 110 110 110 110 110 110 110 110 
110 110 110 110 110 110 110 110 110 110 110 109 109 109 109 109 109 109 109 109 109 109 109 110 110 110 110 110 110 110 
110 110 110 110 110 110 110 110 110 110 109 109 109 109 109 109 109 109 109 109 109 109 109 109 110 110 110 110 110 110 
110 110 110 110 110 110 110 110 110 109 109 109 109 109 109 109 108 108 108 109 109 109 109 109 109 109 110 110 110 110 
110 110 110 110 110 110 110 110 109 109 109 109 109 109 108 108 108 108 108 108 109 109 109 109 109 109 109 110 110 110 
110 110 110 110 110 110 110 109 109 109 109 109 109 108 108 108 108 108 108 108 108 108 109 109 109 109 109 109 110 110 
110 110 110 110 110 110 110 109 109 109 109 109 109 108 108 108 108 108 108 108 108 108 108 109 109 109 109 109 110 110 
110 110 110 110 110 110 110 109 109 109 109 109 109 109 108 108 108 108 108 108 108 108 108 109 109 109 109 109 110 110 
110 110 110 110 110 110 110 110 109 109 109 109 109 109 109 108 108 108 108 108 108 108 109 109 109 109 109 110 110 110 
110 110 110 110 110 110 110 110 110 109 109 109 109 109 109 109 108 108 108 108 108 109 109 109 109 109 110 110 110 110 
110 110 110 110 110 110 110 110 110 110 109 109 109 109 109 109 109 108 108 109 109 109 109 109 109 110 110 110 110 110 
110 110 110 110 110 110 110 110 110 110 110 109 109 109 109 109 109 109 109 109 109 109 109 109 110 110 110 110 110 110 
110 110 110 110 110 110 110 110 110 110 110 110 110 109 109 109 109 109 109 109 109 109 109 110 110 110 110 110 110 110 
110 110 110 110 110 110 110 110 110 110 110 110 110 110 110 110 110 110 110 110 110 110 110 110 110 110 110 110 110 110 
110 110 110 110 110 110 110 110 110 110 110 110 110 110 110 110 110 110 110 110 110 110 110 110 110 110 110 110 110 110 
110 110 110 110 110 110 110 110 110 110 110 110 110 110 110 110 110 110 110 110 110 110 110 110 110 110 110 110 110 110 
