0 0 0 0 0 0 0 0 0 0 0 0 0 0 80 81 82 0 0 0 0 0 0 0 0 0 0 0 0 0 
0 0 0 0 0 0 0 0 0 0 0 0 0 0 84 85 86 0 0 0 0 0 0 0 0 0 0 0 0 0 
0 0 0 0 0 0 0 0 0 0 0 0 0 0 88 89 0 0 0 0 0 0 0 0 0 0 54 55 0 289 
0 0 0 0 0 0 0 0 0 0 0 0 0 0 92 93 0 0 0 0 0 0 52 53 0 0 0 0 289 285 
0 0 0 0 0 0 0 0 0 0 325 154 154 324 128 131 325 154 154 324 0 0 0 0 0 0 0 0 283 0 
0 0 0 0 0 52 53 0 0 0 158 144 153 326 0 0 327 153 147 157 0 0 0 0 0 0 0 0 283 0 
155 154 154 154 154 155 154 154 155 154 149 157 44 0 0 0 0 44 159 148 155 155 154 155 155 155 154 324 283 0 
144 152 152 152 152 152 152 152 153 152 152 326 0 0 0 0 0 0 327 153 152 153 153 152 153 152 153 326 291 281 
157 0 0 0 0 0 0 0 0 0 0 0 0 0 0 0 0 0 0 0 0 0 0 0 0 0 0 0 0 283 
148 154 155 154 154 155 154 154 155 154 154 324 0 0 0 0 0 0 325 154 155 154 154 155 154 154 155 324 289 285 
152 153 152 153 153 153 153 153 152 152 145 156 44 0 0 0 0 44 158 146 153 152 152 152 152 153 153 326 283 0 
0 54 55 0 0 0 0 0 0 0 158 148 154 324 0 0 325 154 151 157 0 0 0 0 0 0 0 0 283 0 
0 0 0 0 0 0 0 0 54 55 327 152 145 156 0 0 159 144 152 326 0 54 55 0 0 0 0 0 283 0 
0 0 0 0 0 0 0 0 0 0 0 0 158 157 0 0 158 157 0 0 0 0 0 0 0 0 0 0 291 281 
0 0 0 0 0 0 0 0 0 0 0 0 327 326 0 0 327 326 0 0 0 0 0 0 0 0 0 0 0 291 
0 0 0 0 0 0 321 319 319 319 319 319 319 320 0 0 321 319 319 319 319 319 319 320 0 0 52 53 0 0 
0 0 0 0 0 321 317 0 0 0 0 0 0 316 319 319 317 0 0 0 0 0 0 316 320 0 0 0 0 0 
