0 0 0 0 0 0 0 0 0 0 0 0 0 0 0 0 0 0 0 0 0 0 0 0 0 0 0 0 0 0 
0 0 0 0 0 0 0 0 0 0 0 0 0 0 146 152 153 152 152 147 0 0 0 0 0 0 0 0 0 0 
0 0 0 0 52 53 0 0 0 54 55 144 153 152 326 0 0 0 0 327 152 153 147 0 0 54 55 0 0 0 
0 0 0 0 0 0 0 0 0 0 146 326 0 0 0 333 123 122 123 332 0 0 327 145 0 0 0 0 0 0 
0 0 0 0 0 0 0 0 0 144 326 0 0 333 122 117 0 0 0 116 332 0 0 327 153 147 0 0 0 0 
0 0 0 0 0 0 0 0 146 326 0 0 333 119 0 0 0 0 0 0 118 123 332 0 0 327 145 0 0 0 
0 0 52 53 0 0 0 144 326 0 0 0 126 0 0 0 0 0 0 0 0 0 118 332 0 0 327 145 0 0 
0 0 0 0 0 0 0 156 0 0 0 0 127 0 0 0 0 0 0 0 0 0 0 124 0 0 0 159 0 0 
0 0 0 0 0 0 0 148 324 0 0 0 335 115 0 0 0 0 0 0 0 0 0 125 0 0 325 149 0 0 
0 0 0 0 0 0 0 0 148 324 0 0 0 335 113 0 0 0 0 0 0 0 114 334 0 325 149 0 0 0 
0 0 0 0 0 0 0 0 0 148 324 0 0 0 335 115 0 0 0 0 0 112 334 0 325 151 0 0 0 0 
0 0 0 0 0 0 0 0 0 0 148 324 0 0 0 335 113 0 0 114 120 334 0 325 149 0 0 0 0 0 
0 0 0 0 0 0 52 53 0 0 0 148 154 324 0 0 335 121 120 334 0 0 325 151 0 0 0 0 0 0 
0 0 0 0 0 0 0 0 0 0 0 0 0 148 154 155 154 155 155 154 155 154 149 0 0 0 52 53 0 0 
0 0 0 0 0 0 0 0 0 0 0 0 0 167 167 163 167 163 0 0 0 0 0 0 0 0 0 0 0 0 
0 0 0 0 54 55 0 0 0 0 0 0 165 169 168 168 169 168 162 0 0 0 0 0 0 0 0 0 0 0 
0 0 0 0 0 0 0 0 0 0 0 165 169 168 169 169 168 169 168 166 0 0 0 0 0 0 0 0 0 0 
