200 175 173 172 176 176 176 176 176 176 176 172 176 172 174 175 174 176 176 176 176 172 175 175 174 174 176 174 172 196 
191 96 96 96 96 96 96 96 96 96 96 96 96 96 96 96 96 96 109 109 109 109 109 109 109 110 110 110 110 182 
189 96 96 96 96 96 96 96 96 96 96 96 96 96 96 96 96 96 96 109 109 109 109 109 109 110 110 110 110 184 
190 96 96 96 96 96 96 96 96 96 96 96 96 96 96 96 96 96 96 96 109 109 109 109 110 110 110 110 110 185 
188 96 96 96 96 209 181 181 181 204 96 96 96 96 96 96 96 96 96 96 109 109 109 109 110 110 110 110 110 185 
191 96 96 96 96 185 216 217 215 187 96 96 96 96 96 96 96 96 96 96 96 109 109 109 110 110 110 110 110 196 
191 96 96 96 96 196 176 176 176 200 96 96 96 96 96 96 96 209 181 205 96 96 109 109 110 110 110 110 110 110 
191 96 96 96 96 96 96 96 96 96 60 60 60 60 60 60 60 185 215 191 96 96 109 109 110 110 110 110 110 110 
191 96 96 96 96 96 96 96 96 96 60 60 60 60 60 60 60 186 215 189 96 109 109 109 110 110 110 110 110 110 
191 96 96 96 96 96 96 96 96 96 96 96 96 96 96 96 96 186 217 189 96 109 109 109 110 110 110 110 110 110 
191 96 96 96 96 96 96 96 96 96 96 96 96 96 96 96 96 186 217 189 96 109 109 109 110 110 110 110 110 110 
191 96 96 96 96 96 96 96 96 96 96 96 96 96 96 96 96 185 217 189 109 109 109 109 110 110 110 110 110 208 
189 96 96 96 96 96 96 96 96 96 96 96 96 96 96 96 96 186 215 191 109 109 110 110 110 110 110 110 110 184 
189 96 96 96 96 96 96 96 96 96 96 96 96 96 96 96 96 184 217 191 109 109 110 110 110 110 110 110 110 183 
188 96 96 96 96 96 96 96 96 96 96 96 96 96 96 96 96 186 215 189 109 109 110 110 110 110 110 110 110 185 
190 96 96 96 96 96 96 96 96 96 96 96 96 96 96 96 96 192 176 198 109 110 110 110 110 110 110 110 110 183 
204 181 181 181 181 181 181 181 181 181 181 181 205 96 96 96 96 210 181 178 181 177 180 180 181 181 177 181 179 206 
