200 175 173 172 176 176 176 175 175 175 175 172 198 96 96 96 96 196 176 176 176 172 175 175 174 174 176 174 172 196 
191 96 96 96 96 96 96 96 96 96 96 96 96 96 96 96 96 96 96 96 96 96 208 181 181 205 96 96 96 182 
189 96 96 96 96 96 96 96 96 96 96 96 96 96 96 96 96 96 96 96 96 96 186 216 217 191 96 96 96 184 
190 96 96 96 96 96 96 96 96 96 96 96 96 96 96 96 96 96 96 96 96 96 185 215 217 188 96 96 96 185 
188 96 96 96 96 96 96 96 96 96 96 96 96 96 96 96 96 96 96 96 96 96 185 215 215 191 96 96 96 185 
191 96 96 96 96 96 96 96 96 96 96 96 96 96 96 96 96 96 96 96 96 96 186 217 217 188 96 96 96 183 
189 96 96 96 96 96 96 96 96 96 96 96 96 96 96 96 96 96 96 96 96 96 186 215 215 189 96 96 96 196 
189 96 96 96 96 96 96 96 206 180 178 178 178 181 177 177 177 177 177 177 181 177 185 217 216 190 96 96 96 96 
188 96 96 96 96 96 96 96 194 173 176 176 175 175 174 174 176 176 176 176 174 176 185 215 216 191 96 96 96 96 
189 96 96 96 96 96 96 96 96 96 96 96 96 96 96 96 96 96 96 96 96 96 185 215 215 191 96 96 96 96 
189 96 96 96 96 96 96 96 96 96 96 96 96 96 96 96 96 96 96 96 96 96 196 176 176 200 96 96 96 96 
191 96 96 96 96 96 96 96 96 96 96 96 96 96 96 96 96 96 96 96 96 96 96 96 96 96 96 96 96 210 
189 96 96 96 96 96 96 96 96 96 96 96 96 96 96 96 96 96 96 96 96 96 96 96 96 96 96 96 96 184 
189 96 96 96 96 96 96 96 96 96 96 96 96 96 96 96 96 96 96 96 96 96 96 96 96 96 96 96 96 183 
188 96 96 96 96 96 96 96 96 96 96 96 96 96 96 96 96 96 96 96 96 96 96 96 96 96 96 96 96 185 
190 96 96 96 96 96 96 96 96 96 96 96 96 96 96 96 96 96 96 96 96 96 96 96 96 96 96 96 96 183 
204 181 181 181 181 181 181 181 181 181 181 181 177 181 181 180 177 179 180 178 181 178 181 181 181 181 177 181 179 206 
