0 0 0 0 0 0 0 0 0 0 0 0 0 0 0 0 99 0 0 0 0 0 0 0 0 0 0 0 0 0 
0 102 0 0 0 0 0 0 0 106 0 0 0 0 0 107 106 107 0 0 99 0 0 0 0 0 0 0 0 0 
0 103 0 0 0 0 0 0 0 0 0 0 0 0 0 0 0 0 0 0 0 0 0 0 0 0 0 0 0 0 
0 99 0 0 0 0 0 0 0 0 0 0 0 0 0 0 0 0 0 0 0 0 0 0 0 0 0 0 0 0 
0 0 0 0 0 0 0 0 0 0 0 0 0 0 0 0 0 0 0 0 0 0 0 0 0 0 0 0 104 0 
0 0 0 0 0 0 0 0 0 58 62 62 62 62 62 62 62 62 62 62 59 0 0 0 0 0 0 0 99 0 
0 0 0 0 0 0 0 0 0 63 65 66 66 73 99 0 72 66 66 75 64 0 0 0 0 0 0 0 0 0 
0 0 0 0 0 0 0 0 0 63 71 98 0 0 0 99 0 0 99 68 64 0 0 0 0 0 0 0 0 105 
0 0 0 0 0 0 0 0 0 63 71 0 0 0 0 97 0 98 0 68 64 0 0 0 0 0 0 97 0 104 
0 0 97 0 0 0 99 0 98 63 71 0 98 0 0 0 0 0 0 68 64 0 0 0 0 0 0 0 0 0 
100 0 0 0 0 0 0 0 0 63 74 76 76 67 0 0 70 76 76 69 64 0 0 0 0 0 0 0 0 105 
0 0 0 0 0 0 0 0 0 57 61 61 61 61 61 61 61 61 61 61 56 0 0 0 0 0 0 0 0 0 
0 103 0 0 0 0 0 0 0 0 0 0 0 0 0 0 0 0 0 0 0 0 0 0 0 0 0 0 0 0 
0 0 0 0 0 0 0 0 0 0 0 0 0 0 0 0 0 0 0 0 0 0 0 0 0 0 0 0 0 0 
0 0 0 0 0 0 0 0 0 0 97 0 0 0 0 0 0 0 0 99 0 0 0 0 0 0 97 0 105 0 
0 0 0 0 0 0 0 0 0 0 0 0 0 101 100 100 0 0 0 0 0 0 0 0 0 101 0 0 0 0 
0 0 0 0 0 0 0 0 0 0 0 0 0 0 0 0 0 0 0 0 0 0 0 0 0 0 0 0 0 0 
