0 0 0 0 0 0 0 0 0 0 0 0 0 0 0 0 0 0 0 0 0 0 0 0 0 0 0 0 0 0 
0 0 0 0 0 0 0 0 0 0 0 0 0 0 0 0 0 0 0 0 0 0 0 0 0 0 0 0 0 0 
0 0 0 0 0 240 241 0 0 0 0 0 0 0 0 0 0 0 0 0 0 0 0 0 0 0 0 0 0 0 
0 0 0 0 0 0 0 0 0 0 0 0 0 0 0 0 0 0 0 0 312 318 318 313 0 0 0 0 0 0 
0 0 0 0 0 0 0 0 0 0 0 0 0 0 0 0 0 0 312 318 322 98 0 323 313 0 0 0 0 0 
0 0 0 0 0 0 0 0 0 0 0 0 0 0 0 0 0 312 322 99 0 0 0 0 323 313 0 0 0 0 
318 313 0 0 0 0 0 0 0 0 0 0 0 0 0 0 312 322 0 0 0 0 0 0 321 317 0 0 0 0 
0 323 313 0 0 0 0 0 0 0 0 0 0 0 0 0 316 320 97 0 0 98 0 321 317 0 0 0 0 0 
0 0 323 318 313 0 0 0 0 0 0 0 0 0 0 0 0 316 320 0 0 0 321 317 0 0 0 0 0 0 
0 0 0 0 323 313 0 0 0 0 0 0 0 0 0 0 0 0 316 320 99 321 317 0 0 0 0 0 0 0 
0 0 0 0 0 0 313 0 0 0 0 0 0 0 0 0 0 0 0 316 319 317 0 0 0 0 0 0 0 0 
0 0 0 0 0 0 323 318 318 313 0 0 0 0 0 0 0 0 0 0 0 0 0 0 0 0 0 0 0 0 
0 0 0 0 0 0 0 0 0 323 318 318 313 0 0 0 0 0 0 0 0 0 0 0 0 0 0 242 243 0 
0 0 0 0 0 0 0 0 0 0 0 0 323 318 318 313 0 0 0 0 0 0 0 0 0 0 0 0 0 0 
0 0 0 0 0 0 0 0 0 0 0 0 0 0 0 323 318 318 318 313 0 0 0 0 0 0 0 0 0 0 
0 0 0 0 0 0 0 0 0 0 0 0 0 0 0 0 0 0 0 323 318 318 318 313 0 0 0 0 0 0 
0 0 0 0 0 0 0 0 0 0 0 0 0 0 0 0 0 0 0 0 0 0 0 323 318 318 313 0 0 0 
