197 176 176 176 176 174 174 174 176 176 173 173 173 174 174 176 176 176 174 176 176 176 172 176 175 176 176 176 176 196 
187 96 96 96 96 96 96 96 96 96 96 96 96 96 96 96 96 96 96 96 96 96 96 96 96 96 96 96 96 184 
191 96 96 96 96 96 96 96 96 96 96 96 96 96 96 96 96 96 96 96 96 96 96 96 96 96 96 96 96 184 
191 96 96 96 96 96 96 96 96 96 96 96 96 96 96 219 96 96 96 96 96 96 96 96 96 96 96 96 96 186 
187 96 96 96 96 96 96 96 96 96 96 96 96 96 219 215 219 96 96 96 96 96 96 96 96 96 96 96 96 186 
200 96 96 96 96 96 96 96 96 96 96 96 96 218 216 215 216 219 96 96 96 96 96 96 96 96 96 96 96 186 
96 96 96 96 96 96 96 96 96 96 96 96 219 215 215 170 215 217 218 96 96 96 96 96 96 96 96 96 96 186 
96 96 96 96 96 96 96 96 96 96 96 219 216 215 170 170 170 217 217 219 96 96 96 96 96 96 96 96 96 184 
96 96 96 96 96 96 96 96 96 96 219 217 215 170 170 170 170 170 216 216 219 96 96 96 96 96 96 96 96 184 
96 96 96 96 96 96 96 96 96 96 96 220 215 215 170 170 170 216 216 220 96 96 96 96 96 96 96 96 96 186 
96 96 96 96 96 96 96 96 96 96 96 96 219 215 215 170 215 215 218 96 96 96 96 96 96 96 96 96 96 186 
202 96 96 96 96 96 96 96 96 96 96 96 96 218 215 215 216 220 96 96 96 96 96 96 96 96 96 96 96 186 
191 96 96 96 96 96 96 96 96 96 96 96 96 96 220 216 219 96 96 96 96 96 96 96 96 96 96 96 96 186 
191 96 96 96 96 96 96 96 96 96 96 96 96 96 96 220 96 96 96 96 96 96 96 96 96 96 96 96 96 184 
187 96 96 96 96 96 96 96 96 96 96 96 96 96 96 96 96 96 96 96 96 96 96 96 96 96 96 96 96 184 
187 96 96 96 96 96 96 96 96 96 96 96 96 96 96 96 96 96 96 96 96 96 96 96 96 96 96 96 96 184 
204 177 180 180 180 180 177 178 178 180 180 180 180 180 178 178 180 180 180 180 180 177 180 180 180 177 177 177 177 208 
