0 0 0 0 0 0 0 0 0 0 0 0 0 0 0 0 0 0 0 0 0 0 0 0 0 0 0 0 0 0 
0 0 0 0 0 106 0 0 0 99 0 306 0 97 0 0 106 107 0 0 0 99 0 0 306 0 107 0 0 0 
0 0 0 98 0 0 0 0 0 99 0 0 0 0 0 0 0 0 0 0 0 0 0 0 0 0 0 0 0 0 
0 0 0 0 0 0 0 0 0 0 0 0 0 0 0 0 0 0 0 0 0 0 0 0 0 0 98 0 0 0 
0 102 305 0 0 0 0 0 0 0 0 0 0 0 0 0 0 0 0 0 0 0 0 0 0 0 0 0 104 0 
0 0 0 0 0 0 0 0 0 0 0 0 0 0 0 0 0 0 0 0 0 102 0 0 0 0 0 0 105 0 
0 0 0 0 0 0 0 0 0 98 0 0 0 0 0 0 0 0 0 0 0 0 58 62 62 0 0 0 0 0 
106 0 0 0 0 0 304 101 0 0 0 0 0 0 0 0 0 0 0 0 0 0 63 0 0 62 62 59 99 0 
97 0 0 0 0 0 0 0 0 0 0 0 0 0 0 0 0 0 0 0 0 0 63 0 0 0 0 64 0 0 
0 0 0 0 0 0 0 0 0 0 0 0 0 0 0 0 0 0 0 0 0 0 63 0 0 0 0 64 0 0 
100 0 0 0 104 0 0 0 0 0 0 0 0 0 0 106 0 0 99 0 0 0 63 0 0 0 0 64 0 0 
0 0 0 0 0 0 0 0 0 0 305 0 0 0 0 0 0 0 0 0 0 107 63 0 0 0 0 64 0 0 
0 0 0 0 0 0 0 0 0 0 0 97 0 0 0 0 0 0 0 0 0 0 63 0 0 0 0 64 0 0 
0 0 0 0 0 0 0 0 0 0 0 0 0 0 0 0 99 0 0 0 0 0 57 61 61 0 0 64 0 0 
0 0 0 0 0 0 0 0 0 0 0 0 0 0 0 0 0 0 0 0 0 0 0 0 0 61 61 56 0 0 
0 0 0 0 0 0 0 0 0 0 0 100 101 0 0 0 0 0 0 101 100 0 0 0 97 0 304 0 0 0 
0 0 0 0 0 0 0 0 0 0 0 0 0 0 0 98 0 0 0 0 0 0 0 0 0 0 0 0 0 0 
