234 234 234 234 234 234 234 234 234 234 234 234 233 233 233 233 233 233 233 233 233 233 234 234 234 234 234 234 234 234 
234 234 234 234 234 234 234 234 234 234 234 233 233 233 233 233 233 233 233 233 233 234 234 234 234 234 234 234 234 234 
234 234 234 234 234 234 234 234 234 234 233 233 233 233 233 233 233 233 233 233 233 234 234 234 234 234 234 234 234 234 
234 234 234 234 234 234 234 234 234 234 233 233 233 233 233 233 233 233 233 233 233 234 234 234 234 234 234 234 234 234 
234 234 234 234 234 234 234 234 234 234 234 233 233 233 233 233 233 233 233 233 233 234 234 234 234 234 234 234 234 234 
234 234 234 234 234 234 234 234 234 234 234 233 233 233 233 233 233 233 233 233 234 234 234 234 234 234 234 234 234 234 
234 234 234 234 234 234 234 234 234 233 233 233 233 233 233 233 233 233 233 233 234 234 234 234 234 234 234 234 234 234 
234 234 234 234 234 234 234 234 234 233 233 233 233 233 233 233 233 233 233 234 234 234 234 234 234 234 234 234 234 234 
234 234 234 234 234 234 234 234 234 233 233 233 233 233 233 233 233 233 233 234 234 234 234 234 234 234 234 234 234 234 
234 234 234 234 234 234 234 234 234 233 233 233 233 233 233 233 233 233 233 234 234 234 234 234 234 234 234 234 234 234 
234 234 234 234 234 234 234 234 234 233 233 233 233 233 233 233 233 233 233 234 234 234 234 234 234 234 234 234 234 234 
234 234 234 234 234 234 234 234 234 233 233 233 233 233 233 233 233 233 233 234 234 234 234 234 234 234 234 234 234 234 
234 234 234 234 234 234 234 234 234 233 233 233 233 233 233 233 233 233 233 234 234 234 234 234 234 234 234 234 234 234 
234 234 234 234 234 234 234 234 234 233 233 233 233 233 233 233 233 233 234 234 234 234 234 234 234 234 234 234 234 234 
234 234 234 234 234 234 234 234 234 234 233 233 233 233 233 233 233 233 233 234 234 234 234 234 234 234 234 234 234 234 
234 234 234 234 234 234 234 234 234 234 234 233 233 233 233 233 233 233 233 234 234 234 234 234 234 234 234 234 234 234 
234 234 234 234 234 234 234 234 234 234 234 234 233 233 233 233 233 233 233 233 234 234 234 234 234 234 234 234 234 234 
