0 0 0 0 0 0 0 0 0 47 141 0 0 0 329 135 47 0 0 0 0 0 0 0 0 0 0 0 0 0 
129 0 0 0 0 0 52 53 0 0 132 328 0 0 143 0 0 0 0 0 0 0 0 0 0 0 0 130 137 136 
331 136 131 0 0 0 0 0 0 0 0 141 0 0 142 0 0 0 0 0 0 0 0 0 128 137 136 330 0 0 
0 0 331 137 129 0 0 0 0 0 0 141 0 0 142 0 0 0 0 0 0 0 0 128 330 0 0 0 0 0 
0 0 0 0 331 136 131 0 0 0 0 141 0 0 143 0 54 55 0 0 128 136 137 330 0 0 0 0 0 0 
0 0 0 0 0 0 331 137 129 0 0 140 0 0 331 136 136 137 136 137 330 0 0 0 0 0 0 0 0 0 
0 0 0 0 0 0 0 0 331 137 136 330 0 0 0 0 108 108 0 0 0 0 0 0 0 0 0 0 0 0 
0 0 0 0 54 55 0 0 0 0 0 0 0 0 0 0 0 108 0 0 0 0 0 0 0 0 0 0 0 0 
0 0 0 0 0 0 0 0 0 0 0 0 0 0 0 0 0 0 0 0 0 0 0 0 0 0 0 0 0 0 
0 0 0 0 0 0 0 0 0 0 0 0 0 0 0 0 0 0 0 0 0 0 0 0 0 0 0 0 0 0 
138 139 328 0 0 0 0 0 0 0 0 0 0 0 0 0 0 0 0 0 0 0 0 0 329 139 139 138 139 138 
0 0 134 139 139 328 0 0 0 0 0 0 0 0 0 0 0 0 0 0 329 138 138 139 133 0 0 0 0 0 
0 0 0 0 0 132 138 139 138 138 139 139 139 139 138 139 139 138 139 138 133 0 0 0 0 0 0 0 0 0 
0 0 0 0 0 0 0 0 0 0 0 0 0 0 0 0 63 0 0 64 0 0 0 0 0 0 0 0 0 0 
0 0 0 0 0 0 0 0 0 0 0 0 0 0 0 0 63 0 0 64 0 0 0 0 0 0 0 0 0 0 
0 0 0 0 0 0 0 0 0 0 0 0 0 0 0 0 63 0 0 64 0 0 0 0 0 0 0 0 0 0 
0 0 0 0 0 0 0 0 0 0 0 0 0 0 0 0 0 61 61 0 0 0 0 0 0 0 0 0 0 0 
