109 109 109 109 109 109 109 109 109 109 108 108 108 108 108 108 109 109 109 109 109 109 109 109 109 109 109 109 109 109 
108 109 109 109 109 109 109 109 109 109 108 108 108 108 108 109 109 109 109 109 109 109 109 109 109 109 109 108 108 108 
108 108 108 109 109 109 109 109 109 109 109 108 108 108 108 109 109 109 109 109 109 109 109 109 108 108 108 108 108 108 
108 108 108 108 108 109 109 109 109 109 109 108 108 108 108 109 109 109 109 109 109 109 109 108 108 108 108 108 108 108 
108 108 108 108 108 108 108 109 109 109 109 108 108 108 108 109 109 109 109 109 108 108 108 108 108 108 108 108 108 108 
108 108 108 108 108 108 108 108 108 109 109 108 108 108 108 108 108 108 108 108 108 108 108 108 108 108 108 108 108 108 
108 108 108 108 108 108 108 108 108 108 108 108 108 108 108 108 108 108 108 108 108 108 108 108 108 108 108 108 108 108 
108 108 108 108 108 108 108 108 108 108 108 108 108 108 108 108 108 108 108 108 108 108 108 108 108 108 108 108 108 108 
108 108 108 108 108 108 108 108 108 108 108 108 108 108 108 108 108 108 108 108 108 108 108 108 108 108 108 108 108 108 
108 108 108 108 108 108 108 108 108 108 108 108 108 108 108 108 108 108 108 108 108 108 108 108 108 108 108 108 108 108 
108 108 108 108 108 108 108 108 108 108 108 108 108 108 108 108 108 108 108 108 108 108 108 108 108 108 108 108 108 108 
33 34 108 108 108 108 108 108 108 108 108 108 108 108 108 108 108 108 108 108 108 108 108 108 108 32 33 33 33 33 
37 37 33 33 34 108 108 108 108 108 108 108 108 108 108 108 108 108 108 108 108 32 33 33 33 37 37 37 37 37 
37 37 37 37 37 33 33 33 33 33 33 33 33 33 33 33 33 60 60 33 33 37 37 37 37 37 37 37 37 37 
37 37 37 37 37 37 37 37 37 37 37 37 37 37 37 37 37 60 60 37 37 37 37 37 37 37 37 37 37 37 
37 37 37 37 37 37 37 37 37 37 37 37 37 37 37 37 37 60 60 37 37 37 37 37 37 37 37 37 37 37 
37 37 37 37 37 37 37 37 37 37 37 37 37 37 37 37 37 37 37 37 37 37 37 37 37 37 37 37 37 37 
