0 0 0 0 0 0 0 0 0 0 0 0 0 0 0 0 0 0 0 0 0 0 0 0 0 0 0 0 0 0 
0 0 0 0 0 0 0 0 0 0 0 0 0 0 0 0 0 0 0 0 0 0 0 0 0 0 0 0 0 0 
0 0 0 0 0 0 0 0 0 58 62 62 62 62 62 62 62 62 62 62 62 62 62 62 62 62 62 62 62 59 
0 0 0 0 0 0 0 0 0 63 44 0 0 0 0 0 0 0 0 44 0 0 0 0 0 0 0 0 44 64 
0 0 0 0 0 0 0 0 0 63 0 0 0 0 0 0 0 0 0 0 0 0 0 0 0 0 0 0 0 64 
0 0 0 0 0 0 0 0 0 63 0 0 0 0 0 0 0 0 0 0 0 0 0 0 0 0 0 0 0 64 
0 0 0 0 0 0 0 0 0 63 0 0 0 0 0 0 0 0 0 0 0 0 0 0 0 0 0 0 0 64 
0 0 0 0 0 0 0 0 0 63 0 0 0 0 0 0 0 0 0 0 0 0 0 0 0 0 0 0 0 64 
0 0 0 0 0 0 0 0 0 63 0 0 0 0 0 0 0 0 0 44 0 0 0 0 0 0 0 0 44 64 
0 0 0 0 0 0 0 0 0 63 0 0 0 0 0 0 0 0 0 0 60 61 61 61 61 61 61 61 61 56 
0 0 0 0 0 0 0 0 0 63 0 0 0 0 0 0 0 0 0 0 64 0 0 0 0 0 0 0 0 0 
0 0 0 0 0 0 0 0 0 63 0 0 0 0 0 0 0 0 0 0 64 0 0 0 0 0 0 0 0 0 
0 0 0 0 0 0 0 0 0 63 0 0 0 0 0 0 0 0 0 0 64 0 0 0 0 0 0 0 0 0 
137 129 0 0 0 0 0 0 0 63 44 0 0 0 0 0 0 0 0 44 64 0 0 0 0 0 0 0 0 0 
0 331 137 136 137 136 129 0 0 57 61 61 61 61 128 129 61 61 61 61 56 0 0 0 0 0 0 0 0 0 
0 0 0 0 0 0 331 136 137 129 0 0 0 0 132 133 0 0 0 0 0 0 0 0 0 0 0 0 0 0 
0 0 0 0 0 0 0 0 0 331 137 136 136 137 137 137 137 136 137 136 137 136 137 136 137 129 0 0 0 0 
