0 0 0 0 0 0 0 0 0 0 0 0 282 0 0 0 0 0 303 293 0 0 309 0 0 0 0 0 0 0 
0 0 0 0 0 0 0 0 0 0 0 0 282 0 0 0 0 0 0 295 0 0 0 0 0 0 310 0 0 0 
0 0 0 0 0 0 0 0 0 0 0 280 290 0 0 0 0 0 0 303 293 308 0 0 0 0 0 0 0 0 
0 0 0 0 0 0 0 0 0 0 0 282 0 0 0 0 0 0 0 0 303 298 293 0 0 0 0 311 0 0 
0 0 0 0 0 0 0 0 0 0 0 282 0 0 0 0 0 0 0 0 0 0 295 0 0 0 0 0 0 0 
0 0 0 0 0 0 0 0 0 0 0 282 0 0 0 0 0 0 0 0 0 0 303 293 310 0 0 0 0 0 
0 0 0 0 0 0 0 0 0 0 280 290 0 0 0 0 0 0 0 0 0 0 0 295 0 0 0 0 0 309 
62 62 62 62 62 62 59 0 0 0 282 0 0 0 0 0 0 0 0 0 0 0 0 303 293 0 0 0 0 0 
0 0 0 0 0 0 64 0 0 0 282 0 0 0 0 0 0 0 0 0 0 0 0 0 295 0 311 0 0 0 
0 0 0 0 0 0 64 0 0 0 282 0 0 0 0 0 0 0 0 0 0 0 0 301 297 0 0 0 0 0 
0 0 0 0 0 0 64 0 0 0 282 0 0 0 0 0 0 0 0 0 0 0 0 295 0 0 0 0 310 0 
61 61 61 61 61 61 56 0 0 0 282 0 0 0 0 0 0 0 0 0 0 0 301 297 308 0 0 0 0 0 
0 0 0 0 0 0 0 0 0 0 282 0 0 0 0 0 0 0 0 0 0 0 295 0 0 0 0 0 0 0 
0 0 0 0 0 0 0 0 0 280 290 0 0 0 0 0 0 0 0 0 0 301 297 0 0 0 0 0 0 0 
0 0 0 0 0 0 0 0 0 282 0 0 0 0 0 0 0 0 0 0 301 297 0 0 0 0 310 0 0 0 
0 0 0 0 0 0 0 0 0 284 288 0 0 0 0 0 0 0 0 301 297 0 311 0 0 0 0 0 309 0 
0 0 0 0 0 0 0 0 0 0 282 0 0 0 0 0 0 0 0 297 0 0 0 0 308 0 0 0 0 0 
