0 0 0 0 0 0 0 0 0 0 0 0 314 0 0 0 0 0 0 0 321 317 0 0 0 0 0 0 0 0 
0 0 0 0 0 0 0 242 243 0 0 312 322 0 0 0 0 0 0 0 315 0 0 0 0 0 0 0 0 0 
0 0 0 0 0 0 0 0 0 0 312 322 0 0 0 0 0 0 0 0 315 0 0 0 0 0 0 0 0 0 
0 0 0 0 0 0 0 0 0 0 316 320 0 0 0 0 0 0 0 0 315 0 0 0 0 0 0 0 0 0 
0 0 0 0 0 0 0 0 0 0 0 314 0 0 0 0 0 0 0 321 317 0 0 0 0 242 243 0 0 0 
0 0 0 0 0 0 0 0 0 0 0 314 0 0 0 0 0 0 0 315 0 0 0 0 0 0 0 0 0 0 
0 0 0 0 0 0 0 0 0 312 318 322 0 0 0 0 0 0 321 317 0 0 0 0 0 0 45 0 0 0 
0 0 0 0 0 0 0 0 0 314 0 0 0 0 0 0 0 0 315 0 0 0 0 0 0 0 0 0 0 0 
0 0 0 0 0 0 0 0 0 314 0 0 0 0 0 0 0 0 315 0 0 0 0 0 0 0 0 0 0 0 
0 0 0 0 0 0 0 0 0 314 0 0 0 0 0 0 0 0 315 0 0 0 0 0 0 0 0 0 0 0 
0 0 0 0 0 0 0 0 0 314 0 0 0 0 0 0 0 0 315 0 0 0 0 0 0 0 45 0 0 0 
0 0 0 0 0 0 0 0 0 314 0 0 0 0 0 0 0 0 315 0 0 0 0 0 0 0 0 0 0 0 
0 0 0 240 241 0 0 0 0 314 0 0 0 0 0 0 0 321 317 0 0 0 0 0 0 0 0 0 0 0 
0 0 0 0 0 0 0 0 0 316 320 0 0 0 0 0 0 315 0 0 0 0 0 0 0 0 0 0 0 0 
0 0 0 0 0 0 0 0 0 0 316 320 0 0 0 0 0 323 313 0 0 0 0 0 0 0 0 0 0 0 
0 0 0 0 0 0 0 0 0 0 0 316 320 0 0 0 0 0 315 0 0 0 0 0 0 0 0 0 0 0 
0 0 0 0 0 0 0 0 0 0 0 0 316 0 0 0 0 0 323 313 0 240 241 0 0 0 0 0 0 0 
