200 175 173 172 176 176 176 175 175 175 175 172 176 176 176 176 176 176 176 176 176 172 175 175 174 174 176 174 172 196 
191 96 96 96 96 96 96 96 96 96 96 225 229 229 229 229 229 229 229 229 229 229 229 229 229 229 229 229 226 182 
189 96 96 96 96 96 96 96 96 96 96 223 221 221 221 221 221 221 221 221 221 221 221 221 221 221 221 222 224 184 
190 96 96 96 96 96 96 96 96 96 96 96 223 222 221 221 221 221 221 221 221 221 221 221 221 221 228 96 96 185 
188 96 96 96 96 96 96 96 96 96 96 96 96 96 223 221 221 221 221 221 221 221 221 221 221 221 224 96 96 185 
191 96 96 96 96 96 96 96 96 96 96 96 96 96 96 223 221 221 221 221 221 221 221 221 222 224 96 96 96 183 
200 96 96 96 96 96 96 96 96 96 96 96 96 96 96 96 223 221 221 221 221 222 222 224 96 96 96 96 96 196 
96 96 96 96 96 96 96 96 96 96 96 96 96 96 96 96 96 223 222 222 224 96 96 96 96 96 96 96 96 96 
96 96 96 96 96 96 96 96 96 96 96 96 96 96 96 96 96 96 96 96 96 96 96 96 96 96 96 96 96 96 
96 96 96 96 96 96 96 208 181 181 180 204 96 96 96 96 96 96 96 96 96 96 96 208 177 205 96 96 96 96 
96 96 96 96 96 96 96 182 217 216 216 188 96 96 96 96 96 96 96 96 96 96 96 186 216 189 96 96 96 96 
201 96 96 96 96 96 96 182 216 215 217 189 96 96 96 96 96 96 96 96 96 96 96 186 215 191 96 96 96 210 
189 96 96 96 96 96 96 192 172 174 176 200 96 96 96 96 96 96 96 96 96 96 96 184 217 191 96 96 96 184 
189 96 96 96 96 96 96 96 96 96 96 96 96 96 96 96 96 96 96 96 96 96 96 186 215 189 96 96 96 183 
188 96 96 96 96 96 96 96 96 96 96 96 96 96 96 96 96 96 96 96 96 96 96 184 216 191 96 96 96 185 
190 96 96 96 96 96 96 96 96 96 96 96 96 96 96 96 96 96 96 96 96 96 96 196 176 200 96 96 96 183 
205 181 181 181 181 181 181 181 181 181 181 181 177 181 181 180 177 179 180 178 181 178 181 181 181 181 177 181 179 206 
