37 37 37 37 37 37 37 42 109 109 109 109 109 109 109 109 109 109 109 109 109 109 109 109 109 109 109 109 109 109 
37 37 37 37 37 37 42 109 109 109 109 109 109 109 109 109 109 109 109 109 109 109 109 109 109 109 109 109 109 109 
37 37 37 37 41 42 109 109 109 109 109 109 109 109 109 109 109 109 109 109 109 109 109 109 109 109 109 109 109 109 
37 41 41 42 109 109 109 109 109 109 109 109 109 109 109 109 109 109 109 109 109 109 109 109 109 109 109 109 109 109 
42 109 109 109 109 109 109 109 109 109 109 109 109 109 170 170 109 109 109 109 109 109 109 109 109 109 109 109 109 278 
109 109 109 109 109 109 109 109 109 109 109 170 170 170 170 170 170 170 170 109 109 109 109 109 109 109 109 109 109 278 
109 109 109 109 109 109 109 109 109 109 109 170 170 170 170 170 170 170 170 109 109 109 109 109 109 109 109 109 109 278 
170 170 170 170 170 170 170 170 170 170 170 170 170 170 170 170 170 170 170 170 170 170 170 170 170 170 170 170 170 170 
170 170 170 170 170 170 170 170 170 170 170 170 170 170 170 170 170 170 170 170 170 170 170 170 170 170 170 170 170 170 
170 170 170 170 170 170 170 170 170 170 170 170 170 170 170 170 170 170 170 170 170 170 170 170 170 170 170 170 170 170 
109 109 109 109 109 109 109 109 109 109 109 170 170 170 170 170 170 170 170 109 109 109 109 109 109 109 109 109 109 278 
109 109 109 109 109 109 109 109 109 109 109 170 170 170 170 170 170 170 170 109 109 109 109 109 109 109 109 109 109 278 
109 109 109 109 109 109 109 109 109 109 109 109 109 170 170 170 170 109 109 109 109 109 109 109 109 109 109 109 109 278 
109 109 109 109 109 109 109 109 109 109 109 109 109 170 170 170 170 109 109 109 109 109 109 109 109 109 109 109 109 109 
109 109 109 109 109 109 109 109 109 109 109 109 109 170 170 170 170 109 109 109 109 109 109 109 109 109 109 109 109 109 
109 109 109 109 109 109 109 109 109 109 109 109 109 170 170 170 170 109 109 109 109 109 109 109 109 109 109 109 109 109 
109 109 109 109 109 109 109 234 234 234 234 234 234 170 170 170 170 234 234 234 234 234 234 109 109 109 109 109 109 109 
