0 0 0 0 0 0 0 0 0 0 0 0 0 0 0 0 0 0 0 0 0 0 0 0 0 0 0 0 0 0 
0 0 0 0 0 0 99 0 0 0 0 0 106 107 0 0 0 142 0 0 0 107 0 0 158 0 0 106 0 0 
0 0 97 0 0 0 0 0 0 0 0 0 0 98 0 0 99 331 129 0 0 0 0 325 151 0 0 0 0 0 
0 103 0 0 0 0 0 100 101 0 0 0 0 0 0 0 0 0 331 131 0 0 0 158 0 0 0 0 0 0 
0 102 0 0 0 0 0 0 0 0 0 0 0 0 0 0 0 0 0 142 0 0 0 159 0 0 0 0 0 0 
0 0 0 0 0 0 0 0 0 0 0 0 0 0 0 0 97 0 97 331 129 0 0 158 0 0 0 0 0 0 
0 0 0 0 0 0 0 0 0 0 62 62 62 62 62 62 62 0 0 0 331 131 0 159 0 0 0 0 0 0 
0 0 0 99 0 107 0 0 0 63 0 0 0 0 0 0 0 0 0 0 329 135 0 158 0 0 0 0 0 0 
0 0 0 0 0 0 0 0 0 63 0 0 0 0 0 0 0 0 0 0 143 0 0 158 0 0 0 0 0 0 
0 0 0 0 0 0 0 0 99 57 61 61 61 61 61 61 61 0 0 0 142 0 0 159 0 0 0 0 0 0 
0 97 0 0 0 0 0 0 0 0 0 0 0 0 0 0 0 0 0 0 133 0 0 158 0 0 0 0 0 101 
0 0 0 0 0 0 0 0 0 0 0 0 0 0 0 0 0 0 0 0 0 325 155 149 0 0 0 0 47 0 
0 0 0 0 0 0 0 0 0 0 0 0 0 0 0 0 0 0 0 0 102 159 0 0 0 0 0 0 0 0 
0 102 0 0 98 0 0 0 0 0 0 0 0 0 0 0 105 0 0 0 0 158 0 0 0 0 0 0 104 0 
0 0 0 0 0 0 0 0 97 0 0 0 0 0 0 0 0 0 0 0 325 149 0 0 0 0 0 0 105 0 
0 0 0 0 0 0 0 0 0 100 101 0 47 0 0 0 0 0 0 0 149 0 101 0 0 0 0 0 0 0 
0 0 0 0 0 0 0 0 0 0 0 0 0 99 0 0 104 0 0 0 0 0 0 0 0 0 0 0 0 0 
