279 279 279 279 279 279 279 279 279 279 279 279 279 279 279 279 279 223 221 221 221 221 221 221 221 221 221 221 221 221 
279 279 279 279 279 279 279 279 279 279 279 279 279 279 279 279 279 279 227 221 221 221 221 221 221 221 221 221 221 221 
279 279 279 279 279 279 279 279 279 279 279 279 279 279 279 279 279 279 227 221 221 221 221 221 221 221 221 221 221 221 
279 279 279 279 279 279 279 279 279 279 279 279 279 279 279 279 279 225 221 221 221 221 221 221 221 221 221 221 221 221 
279 279 279 279 279 279 279 279 279 279 279 279 279 279 279 279 279 227 221 221 221 221 221 221 221 221 221 221 221 221 
279 279 279 279 279 279 279 279 279 279 279 279 279 279 279 279 279 227 221 221 221 221 221 221 221 221 221 221 221 221 
279 279 279 279 279 279 279 279 279 279 279 279 279 279 279 279 279 223 221 221 221 221 221 221 221 221 221 221 221 221 
279 279 279 279 279 279 279 279 279 279 279 279 279 279 279 279 279 279 227 221 221 221 221 221 221 221 221 221 221 221 
279 279 279 279 278 278 278 278 279 279 279 279 279 279 279 279 279 279 60 60 60 60 60 60 60 60 60 60 60 60 
279 279 279 278 278 278 278 278 278 279 279 279 279 279 279 279 279 279 279 60 60 60 60 60 60 60 60 60 60 60 
278 278 278 278 278 278 278 278 278 278 279 279 279 279 279 279 279 279 279 60 60 60 60 60 60 60 60 60 60 60 
278 278 278 278 278 278 278 278 278 278 278 278 279 279 279 279 279 279 279 227 221 221 221 221 221 221 221 221 221 221 
278 278 278 278 278 278 278 278 278 278 278 278 278 278 278 278 279 279 279 223 221 221 221 221 221 221 221 221 221 221 
278 278 278 278 278 278 278 278 278 278 278 278 278 278 278 278 278 279 279 279 223 221 221 221 221 221 221 221 221 221 
278 278 278 278 278 278 278 278 278 278 278 278 278 278 278 278 278 278 279 279 279 223 221 221 221 221 221 221 221 221 
278 278 278 278 278 278 278 278 278 278 278 278 278 278 278 278 278 278 278 278 279 279 227 221 221 221 221 221 221 221 
278 278 278 278 278 278 278 278 278 278 278 278 278 278 278 278 278 278 278 278 278 278 227 221 221 221 221 221 221 221 
