0 0 0 0 0 0 0 0 0 0 0 0 0 0 0 0 0 83 0 0 0 0 0 0 71 0 0 0 0 0 
0 0 0 0 0 0 0 0 0 0 0 0 0 0 0 0 0 87 0 0 0 0 0 0 71 0 50 51 0 0 
0 0 0 0 0 0 0 0 35 0 0 0 0 0 0 0 90 91 0 0 0 0 48 49 71 0 0 0 0 0 
0 0 0 0 0 0 0 0 0 0 0 0 0 0 0 0 94 0 0 0 0 0 0 0 74 76 76 76 76 76 
0 0 35 0 0 48 49 0 0 0 0 0 0 0 0 0 0 0 0 0 35 0 0 0 0 0 0 0 0 0 
0 0 0 0 0 0 0 0 0 0 0 0 0 0 0 0 0 0 0 0 0 0 0 0 0 0 0 0 0 0 
0 0 0 0 0 0 0 0 0 0 275 0 0 0 0 0 0 0 0 276 0 0 0 0 0 0 0 0 283 0 
0 0 0 0 0 0 0 0 0 0 0 0 0 0 0 0 0 0 0 0 0 0 0 0 0 0 0 0 0 0 
0 0 0 0 0 0 0 0 0 0 0 0 0 0 0 0 0 0 0 0 0 0 0 0 0 0 0 0 0 0 
0 0 0 0 0 0 0 0 0 0 0 0 0 0 0 0 0 0 0 0 0 0 0 0 0 0 0 0 0 0 
0 50 51 0 0 0 0 0 0 0 275 0 0 0 0 0 0 0 0 276 0 0 0 0 0 0 0 0 283 0 
0 0 0 0 0 0 0 0 50 51 0 0 0 0 0 0 0 0 0 0 0 50 51 0 0 35 0 0 0 0 
0 0 0 0 0 0 35 0 0 0 0 0 274 0 0 0 0 274 0 0 0 0 0 0 0 0 0 0 0 0 
66 66 66 66 75 0 0 0 0 0 0 0 0 0 0 0 0 0 0 0 0 0 0 0 0 0 0 0 0 0 
0 0 35 0 68 0 0 0 0 0 0 0 0 0 0 0 0 0 0 0 35 0 0 0 0 0 48 49 0 0 
0 0 0 0 68 0 0 0 0 0 0 0 319 0 0 0 0 319 0 0 0 0 0 0 0 0 0 0 0 0 
0 0 0 0 68 0 0 0 0 0 0 0 0 0 0 0 0 0 0 0 0 0 0 0 0 0 0 0 0 0 
