221 221 221 221 221 221 221 221 221 221 221 221 221 221 221 221 221 221 221 221 221 221 221 221 222 222 222 222 222 222 
221 221 221 221 221 221 221 221 221 221 221 221 221 221 221 221 221 221 221 221 221 222 222 224 215 215 215 217 215 215 
221 221 221 221 221 221 221 221 221 221 221 221 221 221 221 221 221 222 222 222 224 216 216 216 216 216 216 216 215 216 
221 221 221 221 221 221 221 221 221 221 221 221 221 221 221 222 224 216 215 215 215 216 216 216 278 278 278 278 278 278 
221 221 221 221 221 221 221 221 221 222 222 222 222 222 224 216 216 215 216 216 215 278 278 278 278 278 278 278 278 278 
221 221 221 221 221 221 221 222 224 217 216 215 216 215 215 215 216 278 278 278 278 278 278 278 278 278 278 278 278 278 
221 221 221 221 221 221 224 216 216 216 278 278 278 278 278 278 278 278 278 278 278 278 278 278 278 278 278 278 278 278 
221 221 221 221 221 224 217 216 278 278 278 278 278 278 278 278 278 278 278 278 278 278 278 278 278 278 278 278 278 278 
221 221 221 221 224 215 215 278 278 278 278 278 278 278 278 278 278 278 278 278 278 278 278 278 278 278 278 278 278 278 
221 222 222 224 216 216 278 278 278 278 278 278 278 278 278 278 278 278 278 278 278 278 278 278 278 278 278 278 278 278 
224 217 216 216 216 278 278 278 278 278 278 278 278 278 278 278 278 278 278 278 278 278 278 278 278 279 279 279 279 279 
215 216 217 216 278 278 278 278 278 278 278 278 278 278 278 278 278 278 278 278 278 278 278 279 279 279 279 279 279 279 
216 278 278 278 278 278 278 278 278 278 278 278 278 278 278 278 278 278 278 279 279 279 279 279 279 279 279 279 279 279 
278 278 278 278 278 278 278 278 278 278 278 278 278 278 278 278 278 279 279 279 279 279 279 279 279 279 279 279 279 279 
278 278 278 278 278 278 278 278 278 278 278 278 278 278 278 278 278 279 279 279 279 279 279 279 279 279 279 279 279 279 
278 278 278 278 278 278 278 278 278 278 278 278 278 278 278 279 279 279 279 279 279 279 279 279 279 279 279 279 279 279 
278 278 278 278 278 278 278 278 278 278 278 278 278 279 279 279 279 279 279 279 279 279 279 279 279 279 279 279 279 279 
